%%%%%%%%
%      %
% D  D %
%  %%  %
%   B  %
% A B  %
%      %
%%%%%%%%