%%%%%%
%    %
% A  %
%  B %
%  D %
%%%%%%